51116-5111116-/
24043p2444443-/
24443-7999998-/
24403-=======-/
24443---------/
24043-----5116/
24444fffff4043/
79998=====7998/
=====-----====
