51111116-5111116------/
24044443p2444443------/
24444443-2444443------/
24444043-2440443------/
24044443-7999998------/
24444443-=======------/
24044443--------------/
24444440fffffffffffp16/
24444443===========-23/
24444443-----511111143/
24444403-----244444043/
24444443-----244444443/
79999998-----244444443/
========-----244404443/
-------------244444443/
-------------799999998/
-------------=========